1,1,1,(M;1;1),1
1,(S;1;2),(M;1;1),1,1
1,1,1,(M;1;1),1
1,(M;1;2),1,(S;1;1),1
1,1,(G;2;1),1,1