1,(S;1;1),1,1,1
1,1,1,1,1
1,(G;3;1),0,1,1
1,1,(S;1;2),(S;1;1),1
1,1,(G;3;1),1,1