1,1,1,(M;0;1),1
1,(S;0;2),(M;0;1),1,1
1,1,1,(M;0;1),1
1,(M;0;2),1,(S;0;1),1
1,1,1,1,1